1111111111111111111111
10000000000000000C0001
1000000000000000000001
1000111111100000000001
100E10C000000000000001
111110000000000E000001
10000000P00000C0000001
1000000000000000000001
1111111111111111111111