1111111111111111111111
1000000000000000000001
1000000000000000000001
1000111111100000000001
100E100000000000000001
111110000000000E000001
10000000P0000000000001
10C0000000000000000001
1111111111111111111111