1111111111111111111111
1000000000000000000001
100000000000000E000001
10000000P0000000000001
100000000000000C000001
1111111111111111111111